p,p,p,p,p,p,p,p,p,p,p,p,p,p,p,p,p,p,p,p,p,p,p,p,p
p,s,-,-,-,-,-,-,-,-,-,-,-,-,-,-,-,-,-,-,-,-,-,-,p
p,p,p,p,p,p,-,-,-,-,-,-,-,-,-,-,-,-,-,-,-,-,-,-,p
p,p,p,p,p,p,x,x,x,x,x,x,x,x,-,-,x,x,x,x,x,x,x,x,p
p,-,-,-,-,-,-,-,-,-,-,-,-,-,-,-,-,-,-,-,-,-,-,-,p
p,-,-,-,-,-,-,-,-,-,-,-,-,-,-,-,-,-,-,-,-,-,-,-,p
p,x,x,x,-,-,x,x,x,x,x,x,x,x,x,x,x,x,x,x,x,-,-,x,p
p,-,-,-,-,-,p,x,-,-,-,-,-,-,-,-,-,-,-,-,-,-,-,-,p
p,-,p,p,p,p,p,x,-,-,-,-,-,-,-,-,-,-,-,-,-,-,-,-,p
p,-,x,x,x,x,x,x,x,x,-,-,x,x,x,x,x,x,x,x,x,x,x,x,p
p,-,-,-,-,-,-,-,-,-,-,-,-,-,-,-,-,-,-,-,-,-,-,-,p
p,-,-,-,-,-,-,-,-,-,p,-,-,-,-,-,-,-,-,-,-,-,-,g,p
p,p,p,p,p,p,p,p,p,p,p,p,p,p,p,p,p,p,p,p,p,p,p,p,p
