p,-,-,-,-,-,-,-,-,-,-,-,-,-,-,-,-,-,-,p
p,-,-,-,-,-,-,-,-,-,-,-,-,-,-,-,-,-,-,p
p,-,-,-,-,-,-,-,-,-,-,-,-,-,-,-,-,-,-,p
p,-,-,-,-,-,-,-,-,-,-,-,-,-,-,-,-,-,-,p
p,-,-,-,-,-,-,-,-,-,-,-,-,-,-,-,-,-,-,p
p,-,-,-,-,-,-,-,-,-,-,-,-,-,-,-,-,-,-,p
p,-,-,-,-,-,-,-,-,-,-,-,-,-,-,-,-,-,-,p
p,-,-,-,-,-,-,-,-,-,-,-,-,-,-,-,-,-,-,p
p,s,-,-,-,-,-,-,-,-,-,-,-,-,-,-,-,-,g,p
p,p,p,p,p,p,p,p,p,p,p,p,p,p,p,p,p,p,p,p
