p,p,p,p,p,p,p,p,p,p,p,p,p,p,p,p,p,p,p,p,p,p,p,p,p
p,-,-,-,-,-,-,-,-,-,-,-,-,-,-,-,-,-,-,-,-,-,-,-,p
p,-,p,p,p,-,p,p,p,-,p,-,-,p,-,p,-,-,-,p,p,-,-,-,p
p,-,p,-,p,-,p,-,p,-,p,-,-,p,p,p,-,-,-,-,p,-,-,-,p
p,-,p,-,p,-,p,-,p,-,p,-,-,-,p,-,-,-,-,-,p,-,-,-,p
p,-,p,p,p,-,p,-,p,-,p,p,p,-,p,-,-,-,-,p,p,p,-,-,p
p,-,-,-,-,-,-,-,-,-,-,-,-,-,-,-,-,-,-,-,-,-,-,-,p
p,-,-,-,-,-,-,-,-,-,-,-,-,-,-,-,-,-,-,-,-,-,-,-,p
p,-,-,-,-,-,-,-,-,-,-,-,-,p,p,p,p,p,p,p,p,p,p,p,p
p,-,-,-,-,-,-,-,-,-,-,-,-,p,-,-,-,-,-,-,-,-,-,-,p
p,p,p,p,p,p,p,p,p,p,p,p,p,p,-,-,-,-,-,-,-,-,-,-,p
p,s,-,-,-,-,-,-,-,-,-,-,-,-,-,-,-,-,y,-,-,-,-,g,p
p,p,p,-,p,-,p,-,p,-,p,-,p,-,p,-,-,-,-,-,-,-,p,p,p