p,p,p,p,p,p,p,p,p,p,p,p,p,p,p,p,p,p,p,p,p,p,p,p,p
p,s,-,-,-,-,-,-,-,-,-,-,-,-,-,-,-,-,-,-,-,-,-,-,p
p,p,p,p,p,p,-,-,-,-,-,-,-,-,-,-,-,-,-,-,-,-,-,-,p
p,p,p,p,p,p,x,x,x,x,x,x,x,x,-,-,x,x,x,x,x,x,x,x,p
p,-,-,-,-,-,-,-,-,-,-,-,-,-,-,-,-,-,-,-,-,-,-,-,p
p,y,-,-,-,-,-,-,-,-,-,-,-,-,-,-,-,-,-,-,-,-,-,-,p
p,f,x,x,-,-,x,x,x,x,x,x,x,x,x,x,x,x,x,x,x,-,-,x,p
p,-,-,-,-,-,p,x,-,-,-,-,-,-,-,-,-,-,-,-,-,-,-,-,p
p,-,p,p,p,p,p,x,-,-,-,-,-,-,-,-,-,-,-,-,-,-,-,-,p
p,-,x,x,x,x,x,x,x,f,-,-,x,x,x,x,x,x,x,x,x,x,x,x,p
p,-,-,-,-,-,-,-,-,-,-,-,-,-,-,-,-,-,-,-,-,-,-,-,p
p,-,-,-,-,-,-,-,-,-,f,-,-,-,-,-,-,-,-,-,-,-,-,g,p
p,p,p,p,p,p,p,p,p,p,p,p,p,p,p,p,p,p,p,p,p,p,p,p,p
